7
6
3 2 2 1 4 3
1 1 3 1 4 3
1 1 1 3 1 1
2 1 4 3 1 1
2 2 3 3 0 1
2 1 1 1 1 1
1 2 2 4 1 1